┌───────┬─────┬─────────────┐
│.......│.....│.............│
│.......│.┌──.│.............│
│.......│.│.............─...│
│..─┐.....│...─.............│
│...│.│.....................│
│.....│.....................│
│.....│.....................│
│.....│.....................│
│.....│.....................│
│.....│...──..............│.│
│...│.....................│.│
│...│...────┬─..──────┬──.│.│
│...........│.........│...│.│
│.....──┬─┐.│...──....│...│.│
│.......│.│...............│.│
│.........│...──┐.......┌─┘.│
│...│...........│.......│...│
│...│.......──┐.│...┌──.│.│.│
│...│.........│.....│.....│.│
│.┌─┘...──┬──.│.....│...──┘.│
│.│.......│...│.....│.......│
│.│.......│.──┤.........┌───┤
│.│...........│.........│...│
│.│...........│......───┘.─.│
│...........................│
│...........................│
│...........................│
└───────────────────────────┘